###################################
#.................................#
#.................................#
#.................................#
#.................................#
#..########...#####...##########..#
#..#............#.........#.......#
#..#............#.........#.......#
#..#............#.........#.......#
#..########.....#.........#.......#
#..#............#.........#.......#
#..#............#.........#.......#
#..#............#.........#.......#
#..#............#.........#.......#
#..#.........#######......#.......#
#.................................#
#.................................#
#.................................#
#.................................#
#.................................#
#.................................#
#.................................#
###################################
...................................
...................................
...................................
...................................
...................................
...................................
...................................
...................................
...................................
...................................
...................................
...................................