###################################
#.................................#
#.................................#
#.....#########...................#
#.................................#
#.................................#
#.................................#
#.......#########.................#
#............#....................#
#...........#.....................#
#...........#.....................#
#...........#.....................#
#...........#....##########.......#
#.................................#
#...........#.....................#
#...........#.....................#
#...........#.....................#
#...#########.....................#
#.................................#
#.................................#
#.................................#
###################################
..................................
..................................
..................................
..................................
..................................
..................................
..................................
..................................
..................................
..................................
..................................
..................................
..................................
