##################################
#................................#
#................................#
#.....#########..................#
#................................#
#................................#
#................................#
#.......#########................#
#............#...................#
#...........#....................#
#...........#....................#
#...........#....................#
#...........#....##########......#
#................................#
#...........#....................#
#...........#....................#
#...........#....................#
#...#########....................#
#................................#
#................................#
#................................#
##################################
..................................
..................................
..................................
..................................
..................................
..................................
..................................
..................................
..................................
..................................
..................................
..................................
..................................
